18 18 18 18 18 18 18 18 18 18 18 18 18 18 18 18 18 18 18 18 18 18 18 18 18 18 18 18 18 18 18 18 18 18 18 18 18 18 18 18 18 18 18 18 18 18 18 18 18 18
18 18 18 18 18 18 18 18 18 18 18 18 18 18 18 18 18 18 18 18 18 18 18 18 18 18 18 18 18 18 18 18 18 18 18 18 18 18 18 18 18 18 18 18 18 18 18 18 18 18
18 18 18 18 18 18 18 18 18 18 18 18 18 18 18 18 18 18 18 18 18 18 18 18 18 18 18 18 18 18 18 18 18 18 18 18 18 18 18 18 18 18 18 18 18 18 18 18 18 18
18 18 18 18 18 18 18 18 18 18 18 18 18 18 18 18 18 18 18 18 18 18 18 18 18 18 18 18 18 18 18 18 18 18 18 18 18 18 18 18 18 18 18 18 18 18 18 18 18 18
18 18 18 18 18 18 18 18 18 18 18 18 18 18 18 18 18 18 18 18 18 18 18 18 18 18 18 18 18 18 18 18 18 18 18 18 18 18 18 18 18 18 18 18 18 18 18 18 18 18
18 18 18 18 18 18 18 18 18 18 3 1 1 1 1 1 1 1 1 1 1 1 1 1 9 9 1 1 1 1 1 1 1 1 1 1 1 1 1 12 18 18 18 18 18 18 18 18 18 18
18 18 18 18 18 18 18 18 18 18 4 0 0 0 0 0 0 0 0 0 0 0 0 0 4 4 0 0 0 0 0 0 0 0 0 0 0 0 0 4 18 18 18 18 18 18 18 18 18 18
18 18 18 18 18 18 18 18 18 18 4 0 0 0 0 0 0 0 0 0 0 0 0 0 4 4 0 0 0 0 0 0 0 0 0 0 0 0 0 4 18 18 18 18 18 18 18 18 18 18
18 18 18 18 18 18 18 18 18 18 4 0 0 3 1 1 2 0 0 0 0 0 0 0 4 4 0 0 11 2 0 0 0 11 1 1 12 0 0 4 18 18 18 18 18 18 18 18 18 18
18 18 18 18 18 18 18 18 18 18 4 0 0 4 0 0 0 0 0 0 0 0 0 0 4 4 0 0 0 0 0 0 0 0 0 0 4 0 0 4 18 18 18 18 18 18 18 18 18 18
18 18 18 18 18 18 18 18 18 18 4 0 0 4 0 0 0 0 0 0 0 0 0 0 4 4 0 0 0 0 0 0 0 0 0 0 4 0 0 4 18 18 18 18 18 18 18 18 18 18
18 18 18 18 18 18 18 18 18 18 4 0 0 4 0 0 0 0 0 0 0 0 0 0 4 4 0 0 0 0 0 0 0 0 0 0 4 0 0 4 18 18 18 18 18 18 18 18 18 18
18 18 18 18 18 18 18 18 18 18 4 0 0 4 0 0 0 0 0 0 0 0 0 0 4 4 0 0 0 0 0 7 0 0 0 0 4 0 0 4 18 18 18 18 18 18 18 18 18 18
18 18 18 18 18 18 18 18 18 18 4 0 0 10 1 1 2 0 0 11 1 1 1 1 4 4 0 0 0 0 0 4 0 0 0 0 4 0 0 4 18 18 18 18 18 18 18 18 18 18
18 18 18 18 18 18 18 18 18 18 4 0 0 4 0 0 0 0 0 0 0 0 0 0 4 4 0 11 1 2 0 4 0 0 14 1 15 0 0 4 18 18 18 18 18 18 18 18 18 18
18 18 18 18 18 18 18 18 18 18 4 0 0 4 0 0 0 0 0 0 0 0 0 0 4 4 0 0 0 0 0 4 0 0 0 0 4 0 0 4 18 18 18 18 18 18 18 18 18 18
18 18 18 18 18 18 18 18 18 18 4 0 0 4 0 0 0 0 0 0 0 0 0 0 4 4 0 0 0 0 0 4 0 0 0 0 4 0 0 4 18 18 18 18 18 18 18 18 18 18
18 18 18 18 18 18 18 18 18 18 4 0 0 4 0 0 0 0 7 0 0 0 0 0 4 4 0 0 0 0 0 13 0 0 0 0 4 0 0 4 18 18 18 18 18 18 18 18 18 18
18 18 18 18 18 18 18 18 18 18 4 0 0 4 0 0 0 0 4 0 0 0 0 0 4 4 0 0 0 0 0 0 0 0 0 0 4 0 0 4 18 18 18 18 18 18 18 18 18 18
18 18 18 18 18 18 18 18 18 18 4 0 0 4 0 0 0 0 4 0 0 0 0 0 4 4 0 0 0 0 0 7 0 0 0 0 4 0 0 4 18 18 18 18 18 18 18 18 18 18
18 18 18 18 18 18 18 18 18 18 4 0 0 5 1 1 1 1 8 1 1 1 1 1 8 8 1 1 1 1 1 8 1 1 1 1 6 0 0 4 18 18 18 18 18 18 18 18 18 18
18 18 18 18 18 18 18 18 18 18 4 0 0 0 0 0 0 0 0 0 0 0 0 0 0 0 0 0 0 0 0 0 0 0 0 0 0 0 0 4 18 18 18 18 18 18 18 18 18 18
18 18 18 18 18 18 18 18 18 18 4 0 0 0 0 0 0 0 0 0 0 0 0 0 0 0 0 0 0 0 0 0 0 0 0 0 0 0 0 4 18 18 18 18 18 18 18 18 18 18
18 18 18 18 18 18 18 18 18 18 4 0 0 0 0 0 0 0 0 0 0 0 0 0 0 0 0 0 0 0 0 0 0 0 0 0 0 0 0 4 18 18 18 18 18 18 18 18 18 18
18 18 18 18 18 18 18 18 18 18 4 0 0 0 3 1 1 1 1 9 1 1 1 12 0 0 3 1 1 1 9 1 1 1 1 12 0 0 0 4 18 18 18 18 18 18 18 18 18 18
18 18 18 18 18 18 18 18 18 18 4 0 0 0 13 0 0 0 0 4 0 0 0 4 0 0 4 0 0 0 4 0 0 0 0 13 0 0 0 4 18 18 18 18 18 18 18 18 18 18
18 18 18 18 18 18 18 18 18 18 4 0 0 0 0 0 0 0 0 4 0 0 0 13 0 0 13 0 0 0 4 0 0 0 0 0 0 0 0 4 18 18 18 18 18 18 18 18 18 18
18 18 18 18 18 18 18 18 18 18 4 0 0 0 0 0 0 0 0 4 0 0 0 0 0 0 0 0 0 0 4 0 0 0 0 0 0 0 0 4 18 18 18 18 18 18 18 18 18 18
18 18 18 18 18 18 18 18 18 18 4 0 0 0 7 0 0 0 0 4 0 0 0 0 0 0 0 0 0 0 4 0 0 0 0 7 0 0 0 4 18 18 18 18 18 18 18 18 18 18
18 18 18 18 18 18 18 18 18 18 4 0 0 0 10 1 1 1 1 15 0 0 0 7 0 0 7 0 0 0 10 1 1 1 1 15 0 0 0 4 18 18 18 18 18 18 18 18 18 18
18 18 18 18 18 18 18 18 18 18 4 0 0 0 13 0 0 0 0 4 0 0 0 4 0 0 4 0 0 0 4 0 0 0 0 13 0 0 0 4 18 18 18 18 18 18 18 18 18 18
18 18 18 18 18 18 18 18 18 18 4 0 0 0 0 0 0 0 0 10 1 1 1 15 0 0 10 1 1 1 15 0 0 0 0 0 0 0 0 4 18 18 18 18 18 18 18 18 18 18
18 18 18 18 18 18 18 18 18 18 4 0 0 0 0 0 0 0 0 4 0 0 0 4 0 0 4 0 0 0 4 0 0 0 0 0 0 0 0 4 18 18 18 18 18 18 18 18 18 18
18 18 18 18 18 18 18 18 18 18 4 0 0 0 7 0 0 0 0 4 0 0 0 13 0 0 13 0 0 0 4 0 0 0 0 7 0 0 0 4 18 18 18 18 18 18 18 18 18 18
18 18 18 18 18 18 18 18 18 18 4 0 0 0 10 1 1 1 1 15 0 0 0 0 0 0 0 0 0 0 10 1 1 1 1 15 0 0 0 4 18 18 18 18 18 18 18 18 18 18
18 18 18 18 18 18 18 18 18 18 4 0 0 0 13 0 0 0 0 4 0 0 0 0 0 0 0 0 0 0 4 0 0 0 0 13 0 0 0 4 18 18 18 18 18 18 18 18 18 18
18 18 18 18 18 18 18 18 18 18 4 0 0 0 0 0 0 0 0 4 0 0 0 7 0 0 7 0 0 0 4 0 0 0 0 0 0 0 0 4 18 18 18 18 18 18 18 18 18 18
18 18 18 18 18 18 18 18 18 18 4 0 0 0 0 0 0 0 0 4 0 0 0 4 0 0 4 0 0 0 4 0 0 0 0 0 0 0 0 4 18 18 18 18 18 18 18 18 18 18
18 18 18 18 18 18 18 18 18 18 4 0 0 0 7 0 0 0 0 10 1 1 1 15 0 0 10 1 1 1 15 0 0 0 0 7 0 0 0 4 18 18 18 18 18 18 18 18 18 18
18 18 18 18 18 18 18 18 18 18 4 0 0 0 10 1 1 1 1 15 0 0 0 4 0 0 4 0 0 0 10 1 1 1 1 15 0 0 0 4 18 18 18 18 18 18 18 18 18 18
18 18 18 18 18 18 18 18 18 18 4 0 0 0 13 0 0 0 0 4 0 0 0 13 0 0 13 0 0 0 4 0 0 0 0 4 0 0 0 4 18 18 18 18 18 18 18 18 18 18
18 18 18 18 18 18 18 18 18 18 4 0 0 0 0 0 0 0 0 4 0 0 0 0 0 0 0 0 0 0 4 0 0 0 0 13 0 0 0 4 18 18 18 18 18 18 18 18 18 18
18 18 18 18 18 18 18 18 18 18 4 0 0 0 0 0 0 0 0 4 0 0 0 0 0 0 0 0 0 0 4 0 0 0 0 0 0 0 0 4 18 18 18 18 18 18 18 18 18 18
18 18 18 18 18 18 18 18 18 18 4 0 0 0 7 0 0 0 0 4 0 0 0 7 0 0 7 0 0 0 4 0 0 0 0 0 0 0 0 4 18 18 18 18 18 18 18 18 18 18
18 18 18 18 18 18 18 18 18 18 4 0 0 0 4 0 0 0 0 4 0 0 0 4 0 0 4 0 0 0 4 0 0 0 0 7 0 0 0 4 18 18 18 18 18 18 18 18 18 18
18 18 18 18 18 18 18 18 18 18 5 1 1 1 8 1 1 1 1 8 1 1 1 8 1 1 8 1 1 1 8 1 1 1 1 8 1 1 1 6 18 18 18 18 18 18 18 18 18 18
18 18 18 18 18 18 18 18 18 18 18 18 18 18 18 18 18 18 18 18 18 18 18 18 18 18 18 18 18 18 18 18 18 18 18 18 18 18 18 18 18 18 18 18 18 18 18 18 18 18
18 18 18 18 18 18 18 18 18 18 18 18 18 18 18 18 18 18 18 18 18 18 18 18 18 18 18 18 18 18 18 18 18 18 18 18 18 18 18 18 18 18 18 18 18 18 18 18 18 18
18 18 18 18 18 18 18 18 18 18 18 18 18 18 18 18 18 18 18 18 18 18 18 18 18 18 18 18 18 18 18 18 18 18 18 18 18 18 18 18 18 18 18 18 18 18 18 18 18 18
18 18 18 18 18 18 18 18 18 18 18 18 18 18 18 18 18 18 18 18 18 18 18 18 18 18 18 18 18 18 18 18 18 18 18 18 18 18 18 18 18 18 18 18 18 18 18 18 18 18
